10
++++++++++
+**+*****+
+**+*****+
+**+*****+
+**+*****+
+**D*****+
+*K+*****+
+**+*****+
+**+****++
++++++++E+